
&File=文件(F)
&Help=帮助(H)
Network=网络
&Import=导入(I)
Add New Server=添加新服务器
&Clear=清除(C)
Custom Fields=自定义字段
&Add...=添加(A)...
Change Folder=更改文件夹
Add New Server=添加新服务器
&New SR...=新建 SR(N)...
Storage=存储
New VM=新建 VM
Logs=日志
Search=搜索
General=常规
Memory=内存
Console=控制台
Networking=网络连接
NICs=NIC
Performance=性能
Users=用户
Power On=开机
&Pool=池(P)
&New Pool...=新建池(N)...
&Server=服务器(S)
V&M=VM(M)
&New VM...=新建 VM(N)...
St&orage=存储(O)
&About XenCenter=关于 XenCenter(A)
Alerts=警报
Change...=更改...
Choose the type of new storage=选择新存储的类型
Review the import settings=查看导入设置
General=常规
Multipathing=多路径
Select the location where the imported VM will be placed=选择用来放置导入 VM 的位置
Select network to connect VM=选择用来连接 VM 的网络
Select target storage=选择目标存储
Locate the file you want to import=查找要导入的文件
Configure storage for the new VM=为新 VM 配置存储
Log Destination=日志目标位置
Clear log entries=清除日志条目
What do you want to call this Storage Repository=要怎样命名该存储库?
Enter a path for your CIFS storage=输入 CIFS 存储的路径
Locate the operating system installation media=查找操作系统安装介质
Allocate processor and memory resources=分配处理器和内存资源
Ready to create the new virtual machine=准备创建新虚拟机
Select a home server=选择主服务器
Name the new virtual machine=为新虚拟机命名
Configure networking on the new VM=在新 VM 上配置网络连接
Select a VM template=选择 VM 模板
Edit tags...=编辑标记...
Citrix XenCenter Setup=Citrix XenCenter 安装程序
Citrix XenCenter Setup Wizard was interrupted=Citrix XenCenter 安装向导中断
